홧팅 -> 화이팅
줠라 -> 존나
쥰내 -> 존나
윾시 -> 역시
읎다 -> 없다
언넝 -> 얼른
엄뫄 -> 엄마
횽님 -> 형님
쨋든 -> 쨌든
천잰가 -> 천재인가
공겜 -> 공포겜
종겜 -> 종합겜
꼰쥬 -> 공주
배뎃 -> 베댓
탕슉 -> 탕수육
쎔네일 -> 썸네일
쌔게 -> 세게
갬성 -> 감성
어쨋 -> 어쨌
어딧 -> 어딨
엤날 -> 옜날
팹시 -> 펩시
귀여웡 -> 귀여워
귀욥네 -> 귀엽네
없눈뎁 -> 없는데
렝커 -> 랭커
멥버쉽 -> 멤버십
멤버쉽 -> 멤버십
젛다 -> 좋다
검샠 -> 검색
뷋팅 -> 베팅
가윕 -> 가입
혜땍 -> 혜택
놀이떵 -> 놀이터
검샏 -> 검색
혼좌 -> 혼자
뫈원 -> 만원
마눤 -> 만원
컨샙 -> 컨셉
렝크 -> 랭크
뎃글 -> 댓글
땨문 -> 때문
맬론 -> 멜론
읎이 -> 없이
다야 -> 다이아